00 01 00 01 00 01 00 01 00 01 00 01 00 01 00 01 00 01 00 01 00 01 00 01 00 01 00 01 00 01 00 01 00 01 00 01 00 01 00 01 00 01 00 01 00 01 00 01 00 01 00 01 00 01 00 01 00 01 00 01 00 01 00 01 00 01 00 01 00 01 00 01 00 01 00 01 00 01 00 01
02 03 02 03 02 03 02 03 02 03 02 03 02 03 02 03 02 03 02 03 02 03 02 03 02 03 02 03 02 03 02 03 02 03 02 03 02 03 02 03 02 03 02 03 02 03 02 03 02 03 02 03 02 03 02 03 02 03 02 03 02 03 02 03 02 03 02 03 02 03 02 03 02 03 02 03 02 03 02 03
00 01 30 31 30 31 30 31 30 31 30 31 30 31 30 31 30 31 30 31 30 31 30 31 30 31 30 31 30 31 30 31 30 31 30 31 30 31 30 31 30 31 30 31 30 31 30 31 30 31 30 31 30 31 30 31 30 31 30 31 30 31 30 31 30 31 30 31 30 31 30 31 30 31 30 31 30 31 00 01
02 03 24 23 27 25 20 29 22 27 27 27 28 21 27 27 28 27 20 27 27 22 28 20 20 20 23 22 21 24 29 23 26 25 20 29 28 20 26 20 23 20 28 28 20 27 29 25 23 20 27 27 23 21 25 20 22 26 25 24 22 27 20 21 27 28 24 29 22 22 22 23 23 23 22 27 27 26 02 03
00 01 23 20 20 25 20 25 24 20 23 27 21 22 24 27 20 20 26 24 27 25 24 29 26 26 23 29 27 23 24 22 27 20 21 29 24 26 29 25 20 23 21 29 27 23 20 20 29 29 24 20 23 24 27 22 23 25 27 22 24 20 28 20 20 25 23 29 27 25 20 21 29 20 23 27 27 26 00 01
02 03 28 21 27 20 25 28 24 22 27 24 25 20 28 23 27 29 29 22 21 20 27 27 23 29 20 25 29 27 27 20 29 20 23 22 20 23 22 24 29 22 29 26 20 25 28 23 26 22 22 27 23 23 25 20 27 22 27 27 28 23 22 21 27 27 23 20 25 20 23 20 28 25 20 27 27 26 02 03
00 01 23 24 20 27 22 22 21 26 24 24 27 29 27 23 22 20 25 20 23 25 25 26 21 20 22 23 24 27 22 20 24 23 23 20 20 20 28 20 26 20 20 27 22 22 20 27 23 25 29 27 22 27 23 26 27 23 20 23 27 23 27 23 20 21 20 20 21 24 24 23 29 23 23 22 29 23 00 01
02 03 22 28 21 20 20 27 20 23 21 25 28 24 28 23 23 23 23 29 23 22 23 21 21 29 20 24 22 22 20 28 27 20 20 29 25 26 20 24 20 27 26 23 22 26 23 23 29 28 20 25 23 22 29 22 20 20 20 26 27 27 23 23 26 23 23 27 27 23 25 27 23 25 21 23 26 26 02 03
00 01 24 23 28 20 23 20 24 23 24 29 27 22 22 00 01 20 23 26 23 20 20 27 22 28 20 23 28 23 23 22 20 25 27 25 21 24 24 27 21 28 23 23 28 21 27 23 27 27 23 27 26 28 20 27 26 23 20 24 29 23 27 28 26 20 24 27 27 20 20 24 20 23 22 29 23 26 00 01
02 03 20 20 27 24 23 20 20 27 20 22 20 26 29 02 03 27 29 24 20 20 20 26 27 23 23 21 20 28 28 25 22 27 23 28 23 21 29 28 20 25 20 26 23 22 27 28 23 20 10 11 12 27 29 25 20 28 23 25 20 28 24 29 22 20 24 24 28 27 28 24 28 22 24 27 21 23 02 03
00 01 26 25 23 26 23 28 20 20 21 23 28 23 28 30 31 29 22 20 23 27 27 23 23 26 28 20 20 24 22 25 25 24 29 27 28 20 27 28 20 26 27 25 27 25 26 26 27 28 13 14 15 25 27 27 27 27 27 20 20 27 22 23 21 27 20 20 27 21 23 20 27 26 23 20 28 28 00 01
02 03 28 23 23 27 27 22 26 20 20 23 27 25 29 26 21 27 20 24 29 23 28 20 27 26 20 21 26 28 26 20 28 24 22 20 22 25 27 25 20 20 24 23 27 27 23 20 23 20 18 49 19 20 25 21 27 21 20 23 20 25 20 22 23 23 23 27 29 20 24 24 25 22 27 29 24 23 02 03
00 01 20 27 23 20 25 20 23 26 27 20 28 24 27 23 21 28 27 28 26 26 22 23 23 23 20 21 25 27 20 22 21 23 23 20 20 23 23 20 20 20 27 22 20 20 28 25 28 26 23 33 25 22 26 22 26 21 20 28 23 20 20 24 27 23 26 20 25 24 28 20 20 21 23 28 26 23 00 01
02 03 20 21 20 20 21 22 25 22 22 27 27 20 22 20 22 20 28 27 27 20 21 25 29 20 26 20 22 29 21 25 29 20 20 20 23 20 27 29 20 21 21 20 20 25 27 22 28 27 20 33 20 28 28 20 26 28 20 20 20 23 25 23 24 20 23 20 27 27 29 21 23 29 25 27 27 24 02 03
00 01 27 29 20 26 24 27 22 24 23 20 20 22 23 20 27 26 26 20 24 20 29 26 20 24 26 26 27 27 20 28 20 27 29 22 24 20 23 27 20 20 28 20 23 23 23 23 23 23 20 33 20 26 20 21 20 23 23 22 27 25 21 20 23 24 20 20 25 21 20 20 20 22 27 20 25 28 00 01
02 03 24 21 27 20 24 22 28 29 26 20 27 24 25 26 29 28 20 27 29 22 21 26 28 27 26 25 24 20 24 25 29 22 23 23 20 20 25 23 25 24 29 40 32 32 32 32 32 32 32 41 20 20 20 20 22 27 27 23 27 24 21 29 27 29 27 22 28 20 20 20 24 27 23 24 23 25 02 03
00 01 26 21 24 26 28 24 27 21 24 28 20 26 21 20 29 24 24 27 23 29 28 20 28 20 28 26 27 28 26 20 22 29 27 22 28 20 21 24 22 25 21 20 23 23 23 23 23 23 23 23 20 26 20 20 20 23 27 21 23 28 24 26 26 27 24 27 23 24 26 29 21 23 21 23 27 20 00 01
02 03 27 23 23 21 23 23 22 23 20 26 24 23 23 24 24 23 27 26 27 24 20 22 27 21 22 27 23 25 23 20 22 20 20 21 25 22 20 25 24 27 29 26 27 25 20 27 20 26 20 20 23 27 27 20 20 23 21 29 27 23 29 25 23 27 20 23 23 20 20 20 27 25 24 20 26 23 02 03
00 01 20 29 29 25 26 20 29 29 24 27 23 26 23 27 25 21 20 21 22 26 22 27 22 25 24 26 23 23 22 21 27 27 20 22 23 27 24 20 27 21 23 24 20 20 26 22 27 26 24 21 20 22 24 20 21 23 25 21 20 29 20 28 27 27 21 21 23 28 22 20 21 27 23 20 23 27 00 01
02 03 20 25 23 28 23 21 27 26 27 23 25 24 24 20 20 21 26 27 20 27 25 28 22 29 28 27 22 20 23 26 23 26 20 24 25 26 24 23 20 26 27 29 29 24 27 29 23 20 23 21 27 29 23 20 28 24 23 20 22 23 21 25 20 22 27 20 27 28 27 27 28 29 27 25 21 22 02 03
00 01 26 23 24 20 26 23 26 23 25 25 23 23 20 27 25 25 20 20 23 23 22 25 21 23 26 25 26 20 22 24 23 23 25 23 27 29 26 20 24 29 23 22 20 24 22 23 29 22 23 27 27 26 24 29 26 20 20 29 25 26 22 27 20 23 24 20 20 27 20 20 20 20 24 22 27 27 00 01
02 03 25 27 25 26 26 21 23 23 20 21 28 25 20 23 20 29 20 24 25 27 23 24 29 25 23 20 23 24 20 23 29 21 27 26 20 27 20 20 20 24 24 20 20 29 28 23 28 26 26 27 26 20 20 29 22 20 28 20 22 20 25 26 23 27 28 20 29 27 21 23 26 20 20 23 21 20 02 03
00 01 27 24 22 27 20 20 20 22 27 22 28 22 20 20 25 24 23 23 20 23 26 20 24 28 20 24 24 20 20 24 20 27 27 25 24 22 24 28 25 29 29 25 27 26 27 29 23 27 28 27 20 22 23 23 20 27 22 22 23 25 23 20 21 27 20 24 21 23 25 27 27 21 29 22 23 20 00 01
02 03 25 21 28 20 20 25 24 28 24 25 27 27 21 27 23 21 27 27 23 22 22 27 20 20 20 27 21 23 21 26 22 25 22 26 28 23 27 20 27 20 28 24 20 21 23 29 20 23 26 20 27 23 23 23 20 20 23 29 20 22 27 20 28 20 22 28 27 23 23 23 25 21 20 26 20 20 02 03
00 01 28 23 20 26 20 20 20 20 24 20 23 20 23 28 26 23 28 20 28 23 20 27 25 27 27 20 25 27 20 21 26 22 23 23 26 22 24 21 23 23 23 20 28 21 21 28 27 26 21 29 23 28 27 25 23 23 28 20 27 28 25 20 23 23 27 20 22 23 28 27 23 29 28 25 22 26 00 01
02 03 22 27 20 23 27 21 20 29 20 21 24 20 25 26 27 20 22 26 27 27 23 23 24 25 24 20 23 29 23 27 24 29 27 27 25 22 20 23 20 28 25 27 23 27 23 20 23 23 29 20 25 29 22 23 24 27 20 27 24 28 28 22 25 22 26 20 29 22 28 29 27 22 29 20 23 21 02 03
00 01 20 20 27 25 29 21 27 23 29 29 24 28 20 26 29 26 26 29 24 26 25 27 22 27 27 20 20 23 20 29 26 28 27 28 23 28 23 24 21 27 29 24 20 20 27 28 20 29 27 27 26 22 27 25 28 29 29 23 25 21 20 20 21 22 28 29 23 21 27 26 21 26 22 27 25 20 00 01
02 03 26 27 23 22 22 27 23 29 25 20 20 27 22 29 28 27 20 25 27 23 23 29 20 27 24 20 24 25 29 26 22 27 22 20 27 28 26 24 27 27 26 21 23 20 27 21 22 20 24 23 28 20 29 20 20 27 22 23 23 25 21 27 25 26 20 29 29 26 27 21 20 22 20 20 29 26 02 03
00 01 24 29 20 28 21 20 23 27 24 20 21 23 27 25 20 27 28 27 22 20 26 23 26 20 21 25 26 26 29 28 20 22 26 20 21 20 28 28 27 20 26 29 26 25 24 23 23 27 28 24 23 26 20 25 20 24 23 20 22 23 20 27 23 24 26 24 20 27 23 22 22 23 23 20 23 24 00 01
02 03 20 20 29 27 21 20 20 27 20 28 22 25 20 26 23 20 27 29 23 20 23 20 20 26 25 28 25 21 29 27 23 26 27 23 20 28 23 25 21 25 23 23 23 20 24 27 23 23 24 26 28 21 23 20 20 20 22 22 20 29 20 23 20 23 26 23 26 27 21 24 26 28 23 27 20 25 02 03
00 01 25 27 23 28 21 27 23 20 27 23 22 27 25 28 23 23 20 24 22 25 20 20 26 20 28 21 20 27 21 23 28 20 28 27 23 28 26 20 23 23 22 23 27 24 27 20 26 20 22 22 26 22 21 28 27 20 29 26 28 23 24 29 24 21 26 28 20 23 20 27 24 24 22 23 20 27 00 01
02 03 20 20 26 22 26 26 21 25 28 27 24 24 27 21 20 27 29 27 27 23 28 23 26 27 20 20 20 24 20 20 27 20 26 23 23 20 20 26 28 26 24 26 28 28 22 25 24 28 21 24 27 27 26 20 20 23 21 20 20 20 28 20 20 20 25 20 20 20 24 27 27 22 22 20 25 26 02 03
00 01 27 22 28 25 20 28 28 29 23 27 27 24 27 23 25 22 29 27 23 20 21 22 21 20 26 27 25 22 29 29 20 23 23 21 27 28 20 29 25 25 23 20 23 21 25 20 27 20 27 25 21 20 24 21 23 27 29 25 28 21 23 20 21 21 21 23 29 27 28 20 24 25 24 20 25 26 55 55
02 03 27 20 25 28 20 27 20 20 20 26 27 24 22 24 28 21 23 28 20 20 22 28 25 23 23 23 23 24 20 27 21 25 27 23 27 23 23 29 20 24 28 20 27 21 27 22 23 27 25 23 22 23 27 22 28 20 24 27 20 22 21 28 28 26 25 21 26 27 24 27 26 28 20 23 20 26 54 54
00 01 25 24 21 27 27 27 21 29 20 23 23 24 21 25 23 22 23 23 24 25 21 20 23 23 22 25 20 24 20 29 28 26 23 20 23 27 23 27 24 27 22 29 23 29 27 20 27 20 29 29 25 21 22 20 22 20 28 20 27 20 23 28 26 20 20 24 20 21 25 27 26 29 27 28 22 20 00 01
02 03 23 20 23 26 20 26 29 29 23 20 21 26 23 20 29 20 20 27 20 20 24 25 28 20 26 23 26 23 21 28 23 24 23 29 29 25 29 28 20 20 25 20 27 24 23 26 24 24 20 20 27 23 20 20 24 23 25 23 23 24 20 20 22 25 29 20 20 22 28 20 23 24 22 23 20 20 02 03
00 01 20 22 27 25 23 20 25 20 20 20 20 24 22 22 23 20 29 25 23 23 27 20 25 23 27 29 23 24 24 29 24 20 24 21 21 28 24 29 23 26 22 22 20 20 24 26 23 20 23 29 23 29 20 25 24 22 26 29 23 25 26 28 20 29 26 20 23 23 24 21 27 26 20 26 20 20 00 01
02 03 23 23 20 29 20 29 28 23 25 22 26 20 20 26 24 26 20 26 27 20 20 20 20 25 27 20 24 23 23 25 27 24 26 28 20 21 20 26 20 20 29 27 25 22 20 22 20 20 29 28 24 22 22 20 28 24 27 21 23 29 20 27 23 28 28 25 27 20 21 27 22 23 20 23 26 23 02 03
00 01 20 28 20 21 20 23 27 20 24 23 23 27 27 25 26 22 22 26 24 20 29 23 24 27 20 20 27 21 20 25 22 22 26 25 27 27 23 23 20 25 21 22 22 28 20 25 26 23 22 21 26 27 22 28 26 29 26 25 20 25 20 29 20 20 29 26 23 20 29 20 29 27 20 26 23 23 00 01
02 03 20 20 27 27 20 27 24 28 24 26 20 20 25 25 20 23 20 23 26 22 20 23 20 21 22 25 27 27 24 25 24 27 23 29 20 22 26 23 29 20 20 22 21 28 20 25 27 25 29 20 20 20 28 26 20 28 28 26 20 29 27 28 29 20 20 21 29 24 28 26 20 24 25 28 29 20 02 03
00 01 25 22 25 20 25 26 28 25 28 27 24 23 27 29 20 26 27 29 20 24 29 29 25 29 23 27 28 27 27 28 28 20 21 25 20 20 29 26 26 28 26 23 22 21 29 24 23 29 23 20 25 26 23 25 27 22 23 20 20 20 27 20 29 26 20 25 26 27 25 29 20 23 20 26 29 27 00 01
02 03 29 20 23 23 28 25 25 21 22 29 21 23 28 25 28 28 22 20 24 23 24 29 23 26 27 24 24 21 27 20 27 20 27 22 20 22 28 20 21 28 20 20 23 25 29 20 28 23 23 22 22 25 25 29 23 29 23 24 29 21 21 22 28 20 23 20 27 27 25 25 20 27 20 26 23 25 02 03
00 01 00 01 00 01 00 01 00 01 00 01 00 01 00 01 00 01 00 01 00 01 00 01 00 01 00 01 00 01 00 01 00 01 00 01 00 01 00 01 00 01 00 01 00 01 00 01 00 01 00 01 00 01 00 01 00 01 00 01 00 01 00 01 00 01 00 01 00 01 00 01 00 01 00 01 00 01 00 01
02 03 02 03 02 03 02 03 02 03 02 03 02 03 02 03 02 03 02 03 02 03 02 03 02 03 02 03 02 03 02 03 02 03 02 03 02 03 02 03 02 03 02 03 02 03 02 03 02 03 02 03 02 03 02 03 02 03 02 03 02 03 02 03 02 03 02 03 02 03 02 03 02 03 02 03 02 03 02 03 
00 01 00 01 00 01 00 01 00 01 00 01 00 01 00 01 00 01 00 01 00 01 00 01 00 01 00 01 00 01 00 01 00 01 00 01 00 01 00 01 00 01 00 01 00 01 00 01 00 01 00 01 00 01 00 01 00 01 00 01 00 01 00 01 00 01 00 01 00 01 00 01 00 01 00 01 00 01 00 01
