00 01 00 01 00 01 00 01 00 01 00 01 00 01 00 01 00 01 00 01 00 01 00 01 00 01 00 01 00 01 00 01 00 01 00 01 00 01 00 01 00 01 00 01 00 01 00 01 00 01 00 01 00 01 00 01 00 01 00 01 00 01 00 01 00 01 00 01 00 01 00 01 00 01 00 01 00 01 00 01 
02 03 02 03 02 03 02 03 02 03 02 03 02 03 02 03 02 03 02 03 02 03 02 03 02 03 02 03 02 03 02 03 02 03 02 03 02 03 02 03 02 03 02 03 02 03 02 03 02 03 02 03 02 03 02 03 02 03 02 03 02 03 02 03 02 03 02 03 02 03 02 03 02 03 02 03 02 03 02 03 
00 01 00 01 00 01 00 01 00 01 00 01 00 01 00 01 00 01 00 01 00 01 00 01 00 01 00 01 00 01 00 01 00 01 00 01 00 01 00 01 00 01 00 01 00 01 00 01 00 01 00 01 00 01 00 01 00 01 00 01 00 01 00 01 00 01 00 01 00 01 00 01 00 01 00 01 00 01 00 01 
02 03 02 03 02 03 02 03 02 03 02 03 02 03 02 03 02 03 02 03 02 03 02 03 02 03 02 03 02 03 02 03 02 03 02 03 02 03 02 03 02 03 02 03 02 03 02 03 02 03 02 03 02 03 02 03 02 03 02 03 02 03 02 03 02 03 02 03 02 03 02 03 02 03 02 03 02 03 02 03 
00 01 00 01 00 01 00 01 00 01 00 01 00 01 00 01 00 01 00 01 00 01 00 01 00 01 00 01 00 01 00 01 00 01 00 01 00 01 00 01 00 01 00 01 00 01 00 01 00 01 00 01 00 01 00 01 00 01 00 01 00 01 00 01 00 01 00 01 00 01 00 01 00 01 00 01 00 01 00 01  
02 03 02 03 02 03 02 03 02 03 02 03 02 03 02 03 02 03 02 03 02 03 02 03 02 03 02 03 02 03 02 03 02 03 02 03 02 03 02 03 02 03 02 03 02 03 02 03 02 03 02 03 02 03 02 03 02 03 02 03 02 03 02 03 02 03 02 03 02 03 02 03 02 03 02 03 02 03 02 03 
00 01 00 01 00 01 00 01 00 01 00 01 00 01 00 01 00 01 00 01 00 01 00 01 00 01 00 01 00 01 00 01 00 01 00 01 00 01 00 01 00 01 00 01 00 01 00 01 00 01 00 01 00 01 00 01 00 01 00 01 00 01 00 01 00 01 00 01 00 01 00 01 00 01 00 01 00 01 00 01  
02 03 02 03 02 03 02 03 02 03 02 03 02 03 02 03 02 03 02 03 02 03 02 03 02 03 02 03 02 03 02 03 02 03 02 03 02 03 02 03 02 03 02 03 02 03 02 03 02 03 02 03 02 03 02 03 02 03 02 03 02 03 02 03 02 03 02 03 02 03 02 03 02 03 02 03 02 03 02 03 
00 01 00 01 00 01 00 01 00 01 00 01 00 01 00 01 00 01 00 01 00 01 00 01 00 01 00 01 00 01 00 01 00 01 00 01 00 01 00 01 00 01 00 01 00 01 00 01 00 01 00 01 00 01 00 01 00 01 00 01 00 01 00 01 00 01 00 01 00 01 00 01 00 01 00 01 00 01 00 01  
02 03 02 03 02 03 02 03 02 03 02 03 02 03 02 03 02 03 02 03 02 03 02 03 02 03 02 03 02 03 02 03 02 03 02 03 02 03 02 03 02 03 02 03 02 03 02 03 02 03 02 03 02 03 02 03 02 03 02 03 02 03 02 03 02 03 02 03 02 03 02 03 02 03 02 03 02 03 02 03 
00 01 00 01 00 01 00 01 00 01 00 01 00 01 00 01 00 01 00 01 00 01 00 01 00 01 00 01 00 01 00 01 00 01 00 01 00 01 00 01 00 01 00 01 00 01 00 01 00 01 00 01 00 01 00 01 00 01 00 01 00 01 00 01 00 01 00 01 00 01 00 01 00 01 00 01 00 01 00 01  
02 03 02 03 02 03 02 03 02 03 02 03 02 03 02 03 02 03 02 03 02 03 02 03 02 03 02 03 02 03 02 03 02 03 02 03 02 03 02 03 02 03 02 03 02 03 02 03 02 03 02 03 02 03 02 03 02 03 02 03 02 03 02 03 02 03 02 03 02 03 02 03 02 03 02 03 02 03 02 03 
00 01 00 01 00 01 00 01 00 01 00 01 00 01 00 01 00 01 00 01 00 01 30 31 30 31 30 31 30 31 30 31 30 31 30 31 30 31 30 31 30 31 30 31 30 31 30 31 30 31 30 31 30 31 30 31 30 31 00 01 00 01 00 01 00 01 00 01 00 01 00 01 00 01 00 01 00 01 00 01  
02 03 02 03 02 03 02 03 02 03 02 03 02 03 02 03 02 03 02 03 02 03 21 21 21 21 21 21 21 21 21 21 21 21 21 21 21 21 21 21 21 21 21 21 21 21 21 21 21 21 21 21 21 21 21 21 21 21 02 03 02 03 02 03 02 03 02 03 02 03 02 03 02 03 02 03 02 03 02 03 
00 01 00 01 00 01 00 01 00 01 00 01 00 01 00 01 00 01 00 01 55 55 21 21 21 21 21 21 21 21 21 21 21 21 21 21 21 21 21 21 21 21 21 21 21 21 21 21 21 21 21 21 21 21 21 21 21 21 00 01 00 01 00 01 00 01 00 01 00 01 00 01 00 01 00 01 00 01 00 01  
02 03 02 03 02 03 02 03 02 03 02 03 02 03 02 03 02 03 02 03 54 54 21 21 21 21 21 21 21 21 21 21 21 21 21 21 21 21 21 21 21 21 21 21 21 21 21 21 21 21 21 21 21 21 21 21 21 21 02 03 02 03 02 03 02 03 02 03 02 03 02 03 02 03 02 03 02 03 02 03 
00 01 00 01 00 01 00 01 00 01 00 01 00 01 00 01 00 01 00 01 00 01 21 21 21 21 21 21 21 21 21 21 21 21 21 21 21 21 21 21 21 21 21 21 21 21 21 21 21 21 21 21 21 21 21 21 21 21 00 01 00 01 00 01 00 01 00 01 00 01 00 01 00 01 00 01 00 01 00 01  
02 03 02 03 02 03 02 03 02 03 02 03 02 03 02 03 02 03 02 03 02 03 21 21 21 21 21 21 21 21 21 21 21 21 21 21 21 21 21 21 21 21 21 21 21 21 21 21 21 21 21 21 21 21 21 21 21 21 02 03 02 03 02 03 02 03 02 03 02 03 02 03 02 03 02 03 02 03 02 03 
00 01 00 01 00 01 00 01 00 01 00 01 00 01 00 01 00 01 00 01 00 01 21 21 21 21 21 21 21 21 21 21 21 21 21 21 21 21 21 21 21 21 21 21 21 21 21 21 21 21 21 21 21 21 21 21 21 21 00 01 00 01 00 01 00 01 00 01 00 01 00 01 00 01 00 01 00 01 00 01  
02 03 02 03 02 03 02 03 02 03 02 03 02 03 02 03 02 03 02 03 02 03 21 21 21 21 21 21 21 21 21 21 21 21 21 21 21 21 21 21 21 21 21 21 21 21 21 21 21 21 21 21 21 21 21 21 21 21 02 03 02 03 02 03 02 03 02 03 02 03 02 03 02 03 02 03 02 03 02 03 
00 01 00 01 00 01 00 01 00 01 00 01 00 01 00 01 00 01 00 01 00 01 21 21 21 21 21 21 21 21 21 21 21 21 21 21 21 21 21 21 21 21 21 21 21 21 21 21 21 21 21 21 21 21 21 21 21 21 00 01 00 01 00 01 00 01 00 01 00 01 00 01 00 01 00 01 00 01 00 01  
02 03 02 03 02 03 02 03 02 03 02 03 02 03 02 03 02 03 02 03 02 03 21 21 21 21 21 21 21 21 21 21 21 21 21 21 21 21 21 21 21 21 21 21 21 21 21 21 21 21 21 21 21 21 21 21 21 21 02 03 02 03 02 03 02 03 02 03 02 03 02 03 02 03 02 03 02 03 02 03 
00 01 00 01 00 01 00 01 00 01 00 01 00 01 00 01 00 01 00 01 00 01 21 21 21 21 21 21 21 21 21 21 21 21 21 21 21 21 21 21 21 21 21 21 21 21 21 21 21 21 21 21 21 21 21 21 21 21 00 01 00 01 00 01 00 01 00 01 00 01 00 01 00 01 00 01 00 01 00 01  
02 03 02 03 02 03 02 03 02 03 02 03 02 03 02 03 02 03 02 03 02 03 21 21 21 21 21 21 21 21 21 21 21 21 21 21 21 21 21 21 21 21 21 21 21 21 21 21 21 21 21 21 21 21 21 21 21 21 02 03 02 03 02 03 02 03 02 03 02 03 02 03 02 03 02 03 02 03 02 03 
00 01 00 01 00 01 00 01 00 01 00 01 00 01 00 01 00 01 00 01 00 01 21 21 21 21 21 21 21 21 21 21 21 21 21 21 21 21 21 21 21 21 21 21 21 21 21 21 21 21 21 21 21 21 21 21 21 21 00 01 00 01 00 01 00 01 00 01 00 01 00 01 00 01 00 01 00 01 00 01  
02 03 02 03 02 03 02 03 02 03 02 03 02 03 02 03 02 03 02 03 02 03 21 21 21 21 21 21 21 21 21 21 21 21 21 21 21 21 21 21 21 21 21 21 21 21 21 21 21 21 21 21 21 21 21 21 21 21 02 03 02 03 02 03 02 03 02 03 02 03 02 03 02 03 02 03 02 03 02 03 
00 01 00 01 00 01 00 01 00 01 00 01 00 01 00 01 00 01 00 01 00 01 21 21 21 21 21 21 21 21 21 21 21 21 21 21 21 21 21 21 21 21 21 21 21 21 21 21 21 21 21 21 21 21 21 21 21 21 00 01 00 01 00 01 00 01 00 01 00 01 00 01 00 01 00 01 00 01 00 01  
02 03 02 03 02 03 02 03 02 03 02 03 02 03 02 03 02 03 02 03 02 03 21 21 21 21 21 21 21 21 21 21 21 21 21 21 21 21 21 21 21 21 21 21 21 21 21 21 21 21 21 21 21 21 21 21 21 21 02 03 02 03 02 03 02 03 02 03 02 03 02 03 02 03 02 03 02 03 02 03 
00 01 00 01 00 01 00 01 00 01 00 01 00 01 00 01 00 01 00 01 00 01 21 21 21 21 21 21 21 21 21 21 21 21 21 21 21 21 21 21 21 21 21 21 21 21 21 21 21 21 21 21 21 21 21 21 21 21 00 01 00 01 00 01 00 01 00 01 00 01 00 01 00 01 00 01 00 01 00 01  
02 03 02 03 02 03 02 03 02 03 02 03 02 03 02 03 02 03 02 03 02 03 21 21 21 21 21 21 21 21 21 21 21 21 21 21 21 21 21 21 21 21 21 21 21 21 21 21 21 21 21 21 21 21 21 21 21 21 02 03 02 03 02 03 02 03 02 03 02 03 02 03 02 03 02 03 02 03 02 03 
00 01 00 01 00 01 00 01 00 01 00 01 00 01 00 01 00 01 00 01 00 01 21 21 21 21 21 21 21 21 21 21 21 21 21 21 21 21 21 21 21 21 21 21 21 21 21 21 21 21 21 21 21 21 21 21 21 21 00 01 00 01 00 01 00 01 00 01 00 01 00 01 00 01 00 01 00 01 00 01  
02 03 02 03 02 03 02 03 02 03 02 03 02 03 02 03 02 03 02 03 02 03 21 21 21 21 21 21 21 21 21 21 21 21 21 21 21 21 21 21 21 21 21 21 21 21 21 21 21 21 21 21 21 21 21 21 21 21 02 03 02 03 02 03 02 03 02 03 02 03 02 03 02 03 02 03 02 03 02 03 
00 01 00 01 00 01 00 01 00 01 00 01 00 01 00 01 00 01 00 01 00 01 00 01 00 01 00 01 00 01 00 01 00 01 00 01 00 01 00 01 00 01 00 01 00 01 00 01 00 01 00 01 00 01 00 01 00 01 00 01 00 01 00 01 00 01 00 01 00 01 00 01 00 01 00 01 00 01 00 01  
02 03 02 03 02 03 02 03 02 03 02 03 02 03 02 03 02 03 02 03 02 03 02 03 02 03 02 03 02 03 02 03 02 03 02 03 02 03 02 03 02 03 02 03 02 03 02 03 02 03 02 03 02 03 02 03 02 03 02 03 02 03 02 03 02 03 02 03 02 03 02 03 02 03 02 03 02 03 02 03 
00 01 00 01 00 01 00 01 00 01 00 01 00 01 00 01 00 01 00 01 00 01 00 01 00 01 00 01 00 01 00 01 00 01 00 01 00 01 00 01 00 01 00 01 00 01 00 01 00 01 00 01 00 01 00 01 00 01 00 01 00 01 00 01 00 01 00 01 00 01 00 01 00 01 00 01 00 01 00 01  
02 03 02 03 02 03 02 03 02 03 02 03 02 03 02 03 02 03 02 03 02 03 02 03 02 03 02 03 02 03 02 03 02 03 02 03 02 03 02 03 02 03 02 03 02 03 02 03 02 03 02 03 02 03 02 03 02 03 02 03 02 03 02 03 02 03 02 03 02 03 02 03 02 03 02 03 02 03 02 03 
00 01 00 01 00 01 00 01 00 01 00 01 00 01 00 01 00 01 00 01 00 01 00 01 00 01 00 01 00 01 00 01 00 01 00 01 00 01 00 01 00 01 00 01 00 01 00 01 00 01 00 01 00 01 00 01 00 01 00 01 00 01 00 01 00 01 00 01 00 01 00 01 00 01 00 01 00 01 00 01  
02 03 02 03 02 03 02 03 02 03 02 03 02 03 02 03 02 03 02 03 02 03 02 03 02 03 02 03 02 03 02 03 02 03 02 03 02 03 02 03 02 03 02 03 02 03 02 03 02 03 02 03 02 03 02 03 02 03 02 03 02 03 02 03 02 03 02 03 02 03 02 03 02 03 02 03 02 03 02 03 
00 01 00 01 00 01 00 01 00 01 00 01 00 01 00 01 00 01 00 01 00 01 00 01 00 01 00 01 00 01 00 01 00 01 00 01 00 01 00 01 00 01 00 01 00 01 00 01 00 01 00 01 00 01 00 01 00 01 00 01 00 01 00 01 00 01 00 01 00 01 00 01 00 01 00 01 00 01 00 01  
02 03 02 03 02 03 02 03 02 03 02 03 02 03 02 03 02 03 02 03 02 03 02 03 02 03 02 03 02 03 02 03 02 03 02 03 02 03 02 03 02 03 02 03 02 03 02 03 02 03 02 03 02 03 02 03 02 03 02 03 02 03 02 03 02 03 02 03 02 03 02 03 02 03 02 03 02 03 02 03 
00 01 00 01 00 01 00 01 00 01 00 01 00 01 00 01 00 01 00 01 00 01 00 01 00 01 00 01 00 01 00 01 00 01 00 01 00 01 00 01 00 01 00 01 00 01 00 01 00 01 00 01 00 01 00 01 00 01 00 01 00 01 00 01 00 01 00 01 00 01 00 01 00 01 00 01 00 01 00 01  
02 03 02 03 02 03 02 03 02 03 02 03 02 03 02 03 02 03 02 03 02 03 02 03 02 03 02 03 02 03 02 03 02 03 02 03 02 03 02 03 02 03 02 03 02 03 02 03 02 03 02 03 02 03 02 03 02 03 02 03 02 03 02 03 02 03 02 03 02 03 02 03 02 03 02 03 02 03 02 03 
00 01 00 01 00 01 00 01 00 01 00 01 00 01 00 01 00 01 00 01 00 01 00 01 00 01 00 01 00 01 00 01 00 01 00 01 00 01 00 01 00 01 00 01 00 01 00 01 00 01 00 01 00 01 00 01 00 01 00 01 00 01 00 01 00 01 00 01 00 01 00 01 00 01 00 01 00 01 00 01  
02 03 02 03 02 03 02 03 02 03 02 03 02 03 02 03 02 03 02 03 02 03 02 03 02 03 02 03 02 03 02 03 02 03 02 03 02 03 02 03 02 03 02 03 02 03 02 03 02 03 02 03 02 03 02 03 02 03 02 03 02 03 02 03 02 03 02 03 02 03 02 03 02 03 02 03 02 03 02 03 
00 01 00 01 00 01 00 01 00 01 00 01 00 01 00 01 00 01 00 01 00 01 00 01 00 01 00 01 00 01 00 01 00 01 00 01 00 01 00 01 00 01 00 01 00 01 00 01 00 01 00 01 00 01 00 01 00 01 00 01 00 01 00 01 00 01 00 01 00 01 00 01 00 01 00 01 00 01 00 01  


 