58 59 58 59 58 59 58 59 58 59 58 59 58 59 58 59 58 59 58 59 58 59 58 59 58 59 58 59 58 59 58 59 58 59 58 59 58 59 58 59 58 59 58 59 58 59 58 59 58 59 58 59 58 59 58 59 58 59 58 59 58 59 58 59 58 59 58 59 58 59 58 59 58 59 58 59 58 59 58 59 
58 59 58 59 58 59 58 59 58 59 58 59 58 59 58 59 58 59 58 59 58 59 58 59 58 59 58 59 58 59 58 59 58 59 58 59 58 59 58 59 58 59 58 59 58 59 58 59 58 59 58 59 58 59 58 59 58 59 58 59 58 59 58 59 58 59 58 59 58 59 58 59 58 59 58 59 58 59 58 59 
58 59 58 59 58 59 58 59 58 59 58 59 58 59 58 59 58 59 58 59 58 59 58 59 58 59 58 59 58 59 58 59 58 59 58 59 58 59 58 59 58 59 58 59 58 59 58 59 58 59 58 59 58 59 58 59 58 59 58 59 58 59 58 59 58 59 58 59 58 59 58 59 58 59 58 59 58 59 58 59 
58 59 58 59 58 59 58 59 58 59 58 59 58 59 58 59 58 59 58 59 58 59 58 59 58 59 58 59 58 59 58 59 58 59 58 59 58 59 58 59 58 59 58 59 58 59 58 59 58 59 58 59 58 59 58 59 58 59 58 59 58 59 58 59 58 59 58 59 58 59 58 59 58 59 58 59 58 59 58 59 
58 59 58 59 58 59 58 59 58 59 58 59 58 59 58 59 58 59 58 59 58 59 58 59 58 59 58 59 58 59 58 59 58 59 58 59 58 59 58 59 58 59 58 59 58 59 58 59 58 59 58 59 58 59 58 59 58 59 58 59 58 59 58 59 58 59 58 59 58 59 58 59 58 59 58 59 58 59 58 59  
58 59 58 59 58 59 58 59 58 59 58 59 58 59 58 59 58 59 58 59 58 59 58 59 58 59 58 59 58 59 58 59 58 59 58 59 58 59 58 59 58 59 58 59 58 59 58 59 58 59 58 59 58 59 58 59 58 59 58 59 58 59 58 59 58 59 58 59 58 59 58 59 58 59 58 59 58 59 58 59 
58 59 58 59 58 59 58 59 58 59 58 59 58 59 58 59 58 59 58 59 58 59 58 59 58 59 58 59 58 59 58 59 58 59 58 59 58 59 58 59 58 59 58 59 58 59 58 59 58 59 58 59 58 59 58 59 58 59 58 59 58 59 58 59 58 59 58 59 58 59 58 59 58 59 58 59 58 59 58 59  
58 59 58 59 58 59 58 59 58 59 58 59 58 59 58 59 58 59 58 59 58 59 58 59 58 59 58 59 58 59 58 59 58 59 58 59 58 59 58 59 58 59 58 59 58 59 58 59 58 59 58 59 58 59 58 59 58 59 58 59 58 59 58 59 58 59 58 59 58 59 58 59 58 59 58 59 58 59 58 59 
58 59 58 59 58 59 58 59 58 59 58 59 58 59 58 59 58 59 58 59 58 59 58 59 58 59 58 59 58 59 58 59 58 59 58 59 58 59 58 59 58 59 58 59 58 59 58 59 58 59 58 59 58 59 58 59 58 59 58 59 58 59 58 59 58 59 58 59 58 59 58 59 58 59 58 59 58 59 58 59  
58 59 58 59 58 59 58 59 58 59 58 59 58 59 58 59 58 59 58 59 58 59 58 59 58 59 58 59 58 59 58 59 58 59 58 59 58 59 58 59 58 59 58 59 58 59 58 59 58 59 58 59 58 59 58 59 58 59 58 59 58 59 58 59 58 59 58 59 58 59 58 59 58 59 58 59 58 59 58 59 
58 59 58 59 58 59 58 59 58 59 58 59 58 59 58 59 58 59 58 59 58 59 58 59 58 59 58 59 58 59 58 59 58 59 58 59 58 59 58 59 58 59 58 59 58 59 58 59 58 59 58 59 58 59 58 59 58 59 58 59 58 59 58 59 58 59 58 59 58 59 58 59 58 59 58 59 58 59 58 59  
58 59 58 59 58 59 58 59 58 59 58 59 58 59 58 59 58 59 58 59 58 59 58 59 58 59 58 59 58 59 58 59 58 59 58 59 58 59 58 59 58 59 58 59 58 59 58 59 58 59 58 59 58 59 58 59 58 59 58 59 58 59 58 59 58 59 58 59 58 59 58 59 58 59 58 59 58 59 58 59 
58 59 58 59 58 59 58 59 58 59 58 59 58 59 58 59 58 59 58 59 58 59 58 59 58 59 58 59 58 59 58 59 58 59 58 59 58 59 58 59 58 59 58 59 58 59 58 59 58 59 58 59 58 59 58 59 58 59 58 59 58 59 58 59 58 59 58 59 58 59 58 59 58 59 58 59 58 59 58 59
58 59 58 59 58 59 58 59 58 59 58 59 58 59 58 59 58 59 58 59 58 59 58 58 58 58 58 58 58 58 58 58 58 58 58 58 58 58 58 58 58 58 58 58 58 58 58 58 58 58 58 58 58 58 58 58 58 58 58 59 58 59 58 59 58 59 58 59 58 59 58 59 58 59 58 59 58 59 58 59 
58 59 58 59 58 59 58 59 58 59 58 59 58 59 58 59 58 59 58 59 58 58 58 58 58 58 58 58 58 58 58 58 58 58 58 58 58 58 58 58 58 58 58 58 58 58 58 58 58 58 58 58 58 58 58 58 58 58 58 59 58 59 58 59 58 59 58 59 58 59 58 59 58 59 58 59 58 59 58 59  
58 59 58 59 58 59 58 59 58 59 58 59 58 59 58 59 58 59 58 59 58 58 58 58 58 58 58 58 58 58 58 58 58 58 58 58 58 58 58 58 58 58 58 58 58 58 58 58 58 58 58 58 58 58 58 58 58 58 58 59 58 59 58 59 58 59 58 59 58 59 58 59 58 59 58 59 58 59 58 59 
58 59 58 59 58 59 58 59 58 59 58 59 58 59 58 59 58 59 58 59 58 59 58 58 58 58 58 58 58 58 58 58 58 58 58 58 58 58 58 58 58 58 58 58 58 58 58 58 58 58 58 58 58 58 58 58 58 58 58 59 58 59 58 59 58 59 58 59 58 59 58 59 58 59 58 59 58 59 58 59  
58 59 58 59 58 59 58 59 58 59 58 59 58 59 58 59 58 59 58 59 58 59 58 58 58 58 58 58 58 08 05 05 05 05 05 05 05 05 05 05 05 05 05 05 05 05 05 05 09 58 58 58 58 58 58 58 58 58 58 59 58 59 58 59 58 59 58 59 58 59 58 59 58 59 58 59 58 59 58 59 
58 59 58 59 58 59 58 59 58 59 58 59 58 59 58 59 58 59 58 59 58 59 58 58 58 58 58 58 58 04 50 50 50 50 50 50 50 50 50 50 50 50 50 50 50 50 50 50 07 58 58 58 58 58 58 58 58 58 58 59 58 59 58 59 58 59 58 59 58 59 58 59 58 59 58 59 58 59 58 59  
58 59 58 59 58 59 58 59 58 59 58 59 58 59 58 59 58 59 58 59 58 59 58 58 58 58 58 58 58 04 50 50 50 50 50 50 50 50 50 50 50 50 50 50 50 50 50 50 07 58 58 58 58 58 58 58 58 58 58 59 58 59 58 59 58 59 58 59 58 59 58 59 58 59 58 59 58 59 58 59 
58 59 58 59 58 59 58 59 58 59 58 59 58 59 58 59 58 59 58 59 58 59 58 58 58 58 58 58 58 04 50 50 50 50 50 50 50 50 50 50 50 50 50 50 50 50 50 50 07 58 58 58 58 58 58 58 58 58 58 59 58 59 58 59 58 59 58 59 58 59 58 59 58 59 58 59 58 59 58 59  
58 59 58 59 58 59 58 59 58 59 58 59 58 59 58 59 58 59 58 59 58 59 58 58 58 58 58 58 58 04 50 50 50 50 50 50 50 50 50 50 50 50 50 50 50 50 50 50 07 58 58 58 58 58 58 58 58 58 58 59 58 59 58 59 58 59 58 59 58 59 58 59 58 59 58 59 58 59 58 59 
58 59 58 59 58 59 58 59 58 59 58 59 58 59 58 59 58 59 58 59 58 59 58 58 58 58 58 58 58 04 50 50 50 50 50 50 50 50 50 50 50 50 50 50 50 50 50 50 07 58 58 58 58 58 58 58 58 58 58 59 58 59 58 59 58 59 58 59 58 59 58 59 58 59 58 59 58 59 58 59  
58 59 58 59 58 59 58 59 58 59 58 59 58 59 58 59 58 59 58 59 58 59 58 58 58 58 58 58 58 04 50 50 50 50 50 50 50 50 50 50 50 50 50 50 50 50 50 50 07 58 58 58 58 58 58 58 58 58 58 59 58 59 58 59 58 59 58 59 58 59 58 59 58 59 58 59 58 59 58 59 
58 59 58 59 58 59 58 59 58 59 58 59 58 59 58 59 58 59 58 59 58 59 58 58 58 58 58 58 58 04 50 50 50 50 50 50 50 50 50 50 50 50 50 50 50 50 50 50 07 58 58 58 58 58 58 58 58 58 58 59 58 59 58 59 58 59 58 59 58 59 58 59 58 59 58 59 58 59 58 59  
58 59 58 59 58 59 58 59 58 59 58 59 58 59 58 59 58 59 58 59 58 59 58 58 58 58 58 58 58 04 50 50 50 50 50 50 50 50 50 50 50 50 50 50 50 50 50 50 07 58 58 58 58 58 58 58 58 58 58 59 58 59 58 59 58 59 58 59 58 59 58 59 58 59 58 59 58 59 58 59 
58 59 58 59 58 59 58 59 58 59 58 59 58 59 58 59 58 59 58 59 58 59 58 58 58 58 58 58 58 04 50 50 50 50 50 50 50 50 50 50 50 50 50 50 50 50 50 50 07 58 58 58 58 58 58 58 58 58 58 59 58 59 58 59 58 59 58 59 58 59 58 59 58 59 58 59 58 59 58 59  
58 59 58 59 58 59 58 59 58 59 58 59 58 59 58 59 58 59 58 59 58 59 58 58 58 58 58 58 58 16 06 06 06 06 06 53 06 06 06 06 06 06 06 06 06 06 06 06 17 58 58 58 58 58 58 58 58 58 58 59 58 59 58 59 58 59 58 59 58 59 58 59 58 59 58 59 58 59 58 59 
58 59 58 59 58 59 58 59 58 59 58 59 58 59 58 59 58 59 58 59 58 59 58 58 58 58 58 58 58 58 58 58 58 58 58 58 58 58 58 58 58 58 58 58 58 58 58 58 58 58 58 58 58 58 58 58 58 58 58 59 58 59 58 59 58 59 58 59 58 59 58 59 58 59 58 59 58 59 58 59  
58 59 58 59 58 59 58 59 58 59 58 59 58 59 58 59 58 59 58 59 58 59 58 58 58 58 58 58 58 58 58 58 58 58 58 58 58 58 58 58 58 58 58 58 58 58 58 58 58 58 58 58 58 58 58 58 58 58 58 59 58 59 58 59 58 59 58 59 58 59 58 59 58 59 58 59 58 59 58 59 
58 59 58 59 58 59 58 59 58 59 58 59 58 59 58 59 58 59 58 59 58 59 58 58 58 58 58 58 58 58 58 58 58 58 58 58 58 58 58 58 58 58 58 58 58 58 58 58 58 58 58 58 58 58 58 58 58 58 58 59 58 59 58 59 58 59 58 59 58 59 58 59 58 59 58 59 58 59 58 59  
58 59 58 59 58 59 58 59 58 59 58 59 58 59 58 59 58 59 58 59 58 59 58 58 58 58 58 58 58 58 58 58 58 58 58 58 58 58 58 58 58 58 58 58 58 58 58 58 58 58 58 58 58 58 58 58 58 58 58 59 58 59 58 59 58 59 58 59 58 59 58 59 58 59 58 59 58 59 58 59 
58 59 58 59 58 59 58 59 58 59 58 59 58 59 58 59 58 59 58 59 58 59 58 59 58 59 58 59 58 59 58 59 58 59 58 59 58 59 58 59 58 59 58 59 58 59 58 59 58 59 58 59 58 59 58 59 58 59 58 59 58 59 58 59 58 59 58 59 58 59 58 59 58 59 58 59 58 59 58 59  
58 59 58 59 58 59 58 59 58 59 58 59 58 59 58 59 58 59 58 59 58 59 58 59 58 59 58 59 58 59 58 59 58 59 58 59 58 59 58 59 58 59 58 59 58 59 58 59 58 59 58 59 58 59 58 59 58 59 58 59 58 59 58 59 58 59 58 59 58 59 58 59 58 59 58 59 58 59 58 59 
58 59 58 59 58 59 58 59 58 59 58 59 58 59 58 59 58 59 58 59 58 59 58 59 58 59 58 59 58 59 58 59 58 59 58 59 58 59 58 59 58 59 58 59 58 59 58 59 58 59 58 59 58 59 58 59 58 59 58 59 58 59 58 59 58 59 58 59 58 59 58 59 58 59 58 59 58 59 58 59  
58 59 58 59 58 59 58 59 58 59 58 59 58 59 58 59 58 59 58 59 58 59 58 59 58 59 58 59 58 59 58 59 58 59 58 59 58 59 58 59 58 59 58 59 58 59 58 59 58 59 58 59 58 59 58 59 58 59 58 59 58 59 58 59 58 59 58 59 58 59 58 59 58 59 58 59 58 59 58 59 
58 59 58 59 58 59 58 59 58 59 58 59 58 59 58 59 58 59 58 59 58 59 58 59 58 59 58 59 58 59 58 59 58 59 58 59 58 59 58 59 58 59 58 59 58 59 58 59 58 59 58 59 58 59 58 59 58 59 58 59 58 59 58 59 58 59 58 59 58 59 58 59 58 59 58 59 58 59 58 59  
58 59 58 59 58 59 58 59 58 59 58 59 58 59 58 59 58 59 58 59 58 59 58 59 58 59 58 59 58 59 58 59 58 59 58 59 58 59 58 59 58 59 58 59 58 59 58 59 58 59 58 59 58 59 58 59 58 59 58 59 58 59 58 59 58 59 58 59 58 59 58 59 58 59 58 59 58 59 58 59 
58 59 58 59 58 59 58 59 58 59 58 59 58 59 58 59 58 59 58 59 58 59 58 59 58 59 58 59 58 59 58 59 58 59 58 59 58 59 58 59 58 59 58 59 58 59 58 59 58 59 58 59 58 59 58 59 58 59 58 59 58 59 58 59 58 59 58 59 58 59 58 59 58 59 58 59 58 59 58 59  
58 59 58 59 58 59 58 59 58 59 58 59 58 59 58 59 58 59 58 59 58 59 58 59 58 59 58 59 58 59 58 59 58 59 58 59 58 59 58 59 58 59 58 59 58 59 58 59 58 59 58 59 58 59 58 59 58 59 58 59 58 59 58 59 58 59 58 59 58 59 58 59 58 59 58 59 58 59 58 59 
58 59 58 59 58 59 58 59 58 59 58 59 58 59 58 59 58 59 58 59 58 59 58 59 58 59 58 59 58 59 58 59 58 59 58 59 58 59 58 59 58 59 58 59 58 59 58 59 58 59 58 59 58 59 58 59 58 59 58 59 58 59 58 59 58 59 58 59 58 59 58 59 58 59 58 59 58 59 58 59  
58 59 58 59 58 59 58 59 58 59 58 59 58 59 58 59 58 59 58 59 58 59 58 59 58 59 58 59 58 59 58 59 58 59 58 59 58 59 58 59 58 59 58 59 58 59 58 59 58 59 58 59 58 59 58 59 58 59 58 59 58 59 58 59 58 59 58 59 58 59 58 59 58 59 58 59 58 59 58 59 
58 59 58 59 58 59 58 59 58 59 58 59 58 59 58 59 58 59 58 59 58 59 58 59 58 59 58 59 58 59 58 59 58 59 58 59 58 59 58 59 58 59 58 59 58 59 58 59 58 59 58 59 58 59 58 59 58 59 58 59 58 59 58 59 58 59 58 59 58 59 58 59 58 59 58 59 58 59 58 59  
58 59 58 59 58 59 58 59 58 59 58 59 58 59 58 59 58 59 58 59 58 59 58 59 58 59 58 59 58 59 58 59 58 59 58 59 58 59 58 59 58 59 58 59 58 59 58 59 58 59 58 59 58 59 58 59 58 59 58 59 58 59 58 59 58 59 58 59 58 59 58 59 58 59 58 59 58 59 58 59 
58 59 58 59 58 59 58 59 58 59 58 59 58 59 58 59 58 59 58 59 58 59 58 59 58 59 58 59 58 59 58 59 58 59 58 59 58 59 58 59 58 59 58 59 58 59 58 59 58 59 58 59 58 59 58 59 58 59 58 59 58 59 58 59 58 59 58 59 58 59 58 59 58 59 58 59 58 59 58 59  
